   #         ################
#  #  #####  ####     #     #
#  #  #      #    #   # ### #
#  #  #####  #  ###   #   # #
#         #       ###     #*#
#############################
